A Day To Remember - For Those Who Have Heart
A Loss For Words - The Kids Can't Lose
Acceptance - Phantoms
Advent - Naked And Cold
American Football - American Football
Anxious - Little Green House
A$AP Rocky - LONG.LIVE.A$AP
Balance and Composure - Separation
Basement - Colourmeinkindness
Bilmuri - American Motor Sports
Bitter End - Climate Of Fear
Black Breath - Sentenced To Life
Born Without Bones - Say Hello
Broadway Calls - Good Views, Bad News
Buried Alive - Death Of Your Perfect World
Cartel - Chroma
Citizen - Youth
City & Colour - Sometimes
Comeback Kid - Wake The Dead
Crime In Stereo - Crime In Stereo Is Dead
Daggermouth - Turf Wars
Dave Hause - Devour
Dead Hearts - Bitter Verses
Defeater - Travels
Denzel Curry - King Of The Mischievous South Vol. 1
Down To Nothing - The Most
Drain - California Cursed
Fall Out Boy - Take This To Your Grave
Finch - What It Is To Burn
Fireworks - Gospel
Figure Four - Suffering The Loss
Foundation - When The Smoke Clears
Four Year Strong - Enemy Of The World
Frank Ocean - Channel Orange
Frank Turner - Love Ire & Song
Fun. - Some Nights
Green Day - American Idiot
Guns Up - Outlive
Hatebreed - Satisfaction Is The Death Of Desire
Have Heart - Songs To Scream At The Sun
Hit The Lights - This Is A Stickup...Don't Make It A Murder
Hostage Calm - Die On Stage
Incendiary - Cost Of Living
Iron Age - Constant Struggle
Jimmy Eat World - Bleed American
Kendrick Lamar - DAMN.
Kid Dynamite - Shorter, Faster, Louder
Killing The Dream - In Places Apart
Knuckle Puck - Copacetic
Koyo - Would You Miss It?
Lydia - Illuminate
Madball - Demonstrating My Style
Make Do And Mend - Everything You Ever Loved
Mayday Parade - A Lesson In Romantics
MGK - Tickets To My Downfall
Mother Of Mercy - IV: Symptoms Of Existence
Never Ending Game - Outcry
New Found Glory - Sticks And Stones
No Pressure - No Pressure (LP)
No Warning - Ill Blood
Off With Their Heads - In Desolation
One King Down - Bloodlust Revenge
One Step Closer - All You Embrace
Panic! At The Disco - A Fever You Can't Sweat Out
Paramore - Riot!
Polar Bear Club - Sometimes Things Just Disappear
Post Malone - Beerbongs & Bentleys
Power Trip - Manifest Decimation
Rage Against The Machine - Rage Against The Machine
Real Friends - Composure
Regulate - Regulate
Rotting Out - Street Prowl
Run The Jewels - RTJ4
Saves The Day - Through Being Cool
Seahaven - Winter Forever
Set Your Goals - Mutiny!
Something Corporate - Leaving Through The Window
Spanish Love Songs - Brave Faces Everyone
Speed - Only One Mode
Strife - In This Defiance
Taking Back Sunday - Tell All Your Friends
Take Offense - Tables Will Turn
Terror - One With The Underdogs
The Gaslight Anthem - The '59 Sound
The Menzingers - On The Impossible Past
The Spill Canvas - One Fell Swoop
The Starting Line - Say It Like You Mean It
The Story So Far - Under Soil And Dirt
The Swellers - Good For Me
The Weeknd - Trilogy
The Wonder Years - The Upsides
Third Eye Blind - Third Eye Blind
Title Fight - Floral Green
Trapped Under Ice - Big Kiss Goodnight
Trial - Are These Our Lives?
Turnover - Peripheral Vision
Turnstile - Glow On
Valencia - We All Need A Reason To Believe
Verse - Aggression
Vision Of Disorder - Vision Of Disorder