American Nightmare - Background Music
Angel Du$t - A.D.
Backtrack - Lost In Life
Bane - Donâ€™t Wait Up
Bitter End - Climate of Fear
Blacklisted - No One Deserves to Be Here More Than Me
Carry On - A Life Less Plagued
Ceremony - Violence, Violence
Code Orange - Forever
Cold World - Dedicated to Babies Who Came Feet First
Comeback Kid - Wake the Dead
Converge - Jane Doe
Cruel Hand - Lock and Key
Defeater - Lost Ground
Death Threat - Peace and Security
Drain - California Cursed
Down To Nothing - The Most
Fiddlehead - Between the Richness
Foundation - When The Smoke Clears
Fury - Paramount
Guns Up - Outlive
Harm's Way - Rust
Have Heart - Songs to Scream at the Sun
Hatebreed - Perseverance
Incendiary - Cost of Living
Iron Age - Constant Struggle
Jesus Piece - Only Self
Kid Dynamite - Shorter, Faster, Louder
Knocked Loose - A Different Shade of Blue
Mental - Get an Oxygen Tank!
Mindforce - Excalibur
Modern Life Is War - Witness
Mother of Mercy - Symptoms of Existence
Nails - Unsilent Death
No Warning - Ill Blood
Poison the Well - Tear from the Red
Power Trip - Nightmare Logic
Rise and Fall - Our Circle Is Vicious
Rotting Out - Street Prowl
Ruiner - Prepare to Be Let Down
Speed - Only One Mode
The Hope Conspiracy - Death Knows Your Name
The Rival Mob - Mob Justice
Throwdown - Haymaker
Terror - One with the Underdogs
Touche Amore - Is Survived By
Trapped Under Ice - Big Kiss Goodnight
Turnstile - Glow On
Verse - Aggression
Walls of Jericho - All Hail the Dead